{
  "Data": [{
      "Data": [2, 2, 3, 2, 2, 2, 2, 2, 2, 3, 0, 0, 2, 2, 2, 2, 2, 2, 2, 2, 2, 2, 2, 2, 2, 2, 2, 2, 2, 0, 0, 2]
    }, {
      "Data": [2, 0, 0, 0, 0, 0, 0, 0, 1, 1, 0, 0, 1, 1, 1, 1, 1, 1, 1, 1, 1, 1, 1, 1, 1, 1, 1, 1, 1, 0, 0, 2]
    }, {
      "Data": [2, 0, 0, 0, 0, 0, 0, 0, 1, 1, 0, 0, 1, 1, 1, 1, 1, 1, 1, 1, 1, 1, 1, 1, 1, 1, 1, 1, 1, 0, 0, 2]
    }, {
      "Data": [2, 0, 0, 1, 1, 1, 0, 0, 1, 1, 0, 0, 1, 1, 1, 1, 0, 0, 0, 0, 0, 0, 0, 0, 0, 0, 1, 1, 1, 0, 0, 2]
    }, {
      "Data": [2, 0, 0, 1, 1, 1, 0, 0, 1, 1, 0, 0, 1, 1, 1, 1, 0, 0, 0, 0, 0, 0, 0, 0, 0, 0, 1, 1, 1, 0, 0, 2]
    }, {
      "Data": [2, 0, 0, 1, 1, 1, 0, 0, 1, 1, 0, 0, 1, 1, 1, 1, 0, 0, 1, 1, 1, 1, 1, 1, 0, 0, 1, 1, 1, 0, 0, 2]
    }, {
      "Data": [2, 0, 0, 1, 1, 1, 0, 0, 1, 1, 0, 0, 1, 1, 1, 1, 0, 0, 1, 1, 1, 1, 1, 1, 0, 0, 1, 1, 1, 0, 0, 2]
    }, {
      "Data": [2, 0, 0, 1, 1, 1, 0, 0, 1, 1, 0, 0, 1, 1, 1, 1, 0, 0, 1, 1, 1, 1, 1, 1, 0, 0, 1, 1, 1, 0, 0, 2]
    }, {
      "Data": [2, 0, 0, 1, 1, 1, 0, 0, 4, 1, 0, 0, 0, 0, 0, 0, 0, 0, 1, 1, 3, 1, 1, 1, 0, 0, 1, 1, 1, 0, 0, 2]
    }, {
      "Data": [2, 0, 0, 1, 1, 1, 0, 0, 1, 1, 0, 0, 0, 0, 0, 0, 0, 0, 1, 1, 1, 1, 1, 1, 0, 0, 1, 1, 1, 0, 0, 2]
    }, {
      "Data": [2, 0, 0, 1, 1, 1, 0, 0, 1, 1, 1, 1, 1, 1, 1, 1, 1, 1, 1, 1, 1, 1, 1, 1, 0, 0, 1, 1, 1, 0, 0, 2]
    }, {
      "Data": [2, 0, 0, 1, 1, 1, 0, 0, 1, 1, 1, 1, 1, 1, 1, 1, 1, 1, 1, 1, 1, 1, 1, 1, 0, 0, 1, 1, 1, 0, 0, 2]
    }, {
      "Data": [2, 0, 0, 0, 0, 0, 0, 0, 0, 0, 0, 0, 0, 0, 0, 0, 0, 0, 0, 0, 0, 0, 0, 0, 0, 0, 1, 1, 1, 0, 0, 2]
    }, {
      "Data": [2, 0, 0, 0, 0, 0, 0, 0, 0, 0, 0, 0, 0, 0, 0, 0, 0, 0, 0, 0, 0, 0, 0, 0, 0, 0, 1, 1, 1, 0, 0, 2]
    }, {
      "Data": [4, 1, 1, 1, 1, 1, 0, 0, 1, 1, 1, 1, 1, 1, 1, 1, 1, 1, 1, 1, 1, 1, 1, 1, 1, 1, 1, 1, 1, 0, 0, 2]
    }, {
      "Data": [2, 1, 1, 1, 1, 1, 0, 0, 1, 1, 1, 1, 1, 1, 1, 1, 1, 1, 1, 1, 1, 1, 1, 1, 1, 1, 1, 1, 1, 0, 0, 2]
    }, {
      "Data": [2, 1, 1, 1, 1, 1, 0, 0, 1, 1, 1, 1, 1, 1, 1, 1, 1, 1, 1, 1, 1, 1, 1, 1, 1, 1, 1, 1, 1, 0, 0, 2]
    }, {
      "Data": [2, 1, 1, 1, 1, 1, 0, 0, 0, 0, 0, 0, 0, 0, 0, 0, 0, 0, 0, 0, 0, 0, 0, 0, 0, 0, 0, 0, 0, 0, 0, 2]
    }, {
      "Data": [2, 1, 1, 1, 1, 1, 0, 0, 0, 0, 0, 0, 0, 0, 0, 0, 0, 0, 0, 0, 0, 0, 0, 0, 0, 0, 0, 0, 0, 0, 0, 2]
    }, {
      "Data": [2, 2, 2, 2, 2, 2, 2, 2, 2, 2, 2, 2, 2, 2, 2, 2, 2, 2, 2, 2, 2, 2, 2, 2, 2, 2, 2, 2, 2, 4, 2, 2]
    }

  ],
  "WayPoint": [{
    "x": 0,
    "y": 0,
    "z": 10.5
  }, {
    "x": 8.5,
    "y": 0,
    "z": 10.5
  }, {
    "x": 8.5,
    "y": 0,
    "z": 16.5
  }, {
    "x": 3.5,
    "y": 0,
    "z": 16.5
  }, {
    "x": 3.5,
    "y": 0,
    "z": 24.5
  }, {
    "x": 12.5,
    "y": 0,
    "z": 24.5
  }, {
    "x": 12.5,
    "y": 0,
    "z": 1.5
  }, {
    "x": 1.5,
    "y": 0,
    "z": 1.5
  }, {
    "x": 1.5,
    "y": 0,
    "z": 6.5
  }, {
    "x": 12.5,
    "y": 0,
    "z": 6.5
  }, {
    "x": 17.5,
    "y": 0,
    "z": 6.5
  }, {
    "x": 17.5,
    "y": 0,
    "z": 29.5
  }, {
    "x": 0,
    "y": 0,
    "z": 29.5
  }],
  "Ways": [{
      "Way": [0, 1, 2, 3, 4, 5, 6, 7, 8, 9, 10, 11, 12]
    },
    {
      "Way": [0, 1, 2, 3, 4, 5, 9, 10, 11, 12]
    },
    {
      "Way": [12, 11, 10, 9, 5, 4, 3, 2, 1, 1, 0]
    }
  ],
  "Name": "Poly"
}